NO textures/red_wall.xpm
SO textures/green_wall.xpm
WE textures/blue_wall.xpm
EA textures/wall.xpm

C 17,213,236
F 231,227,18

1111                                                           111
100000000000000000000000000000000000000000000000000000000000000001
100000000000000000000000000000000000000000000000000000000000000001
100000000000000000000000000000000000000000000000000000000000000001
100000E0000000000000000000001100000000000000000000000000000000000
10000000000000000000000000000000000000000000000000000000000000000
100000000000000000000000000000000000000000000000000000000000000001
100000000000000000000000000000000000000000000000000000000000000001
111111111111111111111111111111111111111111111111111111111111111111