NO textures/red_wall.xpm
SO textures/green_wall.xpm
WE textures/blue_wall.xpm
EA textures/wall.xpm

1111111111111111111111111
1000000000000000000000001
100000000000N000000000001
1000000000000000000000001
1111111111111111111111111

C 170,213,236
F 231,227,18
