NO textures/no.xpm
SO textures/so.xpm
WE textures/we.xpm
EA textures/ea.xpm

C 53,41,34
F 45,33,27

111111111111111
111111000111111
111110000011111
111100000001111
1110000S0000111
110000000000011
100001111100001
110000111000011
111000010000111
111100000001111
111110000011111
111111000111111
111111111111111
