F 220,100,0
C 300,30,0

NO textures/wall_north.xpm
SO textures/wall_south.xpm
WE textures/wall_west.xpm
EA textures/wall_east.xpm

1111111111111
1000000000001
1000000000001
1000000000001
1000000000001
1000000000001
100000N000001
1111111111111