NO ./textures/red_wall.xpm
SO ./textures/green_wall.xpm
WE ./textures/blue_wall.xpm
EA ./textures/wall.xpm

C 17,213,236
F 231,227,18

11111111111111111111111111111111111111111111111111111111111111111111111111111111
10000000000000000000000000100011111111111111111111111111111111110000000000000001     111111111
10001111110000000000000000100011111111111111000000000111111111110000000000000001     100000001
1000000000000000000000000000001111111111111100000000011111111111000000000000000111111100000001
1000000000000000000000000000000111111111111100000000011111111111000000000000000000000000000001
1000000000000000000000000000001111111111111100000000011111111111000000000000000111111100000001
10000000000000000000000000000011111111111111111101111111111111110000000000000001     100000001
11111111111111111111000111111111111111111100000000000001111111111111101111111111     111111111
10000000000000000000000000000001111110000000000000000000000001100000000000001111
10000000000000000000000000000001111110000000000000000000000001100000000000001111
10000000000000000000000000000001111110000000000000000000000001100000000000001001
10000000000000000000000000000000000000000000000000000000000000000000000000001001
1000000000000000000000000000000111111000000000000W000000000001100000000000001001
11111111111111111111111111111111111110000000000000000000000001100000000000001001
                                    10000000000000000000000001100000000000000001
                                    10000000000000000000000001100000000000001101
                                    11111111111111111111111111111111111111111001
                                          10000000000000010000000000000000000001
                                          10000000000000000000000000000000000001
                                          10000000000000010000000000000000000001
                                          10000000000000010000000000000000000001
                                          11111111111111111111111111111111111111